SM	population
tsk_CHB_0	CHB
tsk_CHB_1	CHB
tsk_CHB_2	CHB
tsk_CHB_3	CHB
tsk_CHB_4	CHB
tsk_CHB_5	CHB
tsk_CEU_0	CEU
tsk_CEU_1	CEU
tsk_CEU_2	CEU
tsk_CEU_3	CEU
tsk_CEU_4	CEU
tsk_CEU_5	CEU
tsk_YRI_0	YRI
tsk_YRI_1	YRI
tsk_YRI_2	YRI
tsk_YRI_3	YRI
tsk_YRI_4	YRI
tsk_YRI_5	YRI
tsk_chimp	chimp
tsk_gorilla	gorilla
tsk_orangutan	orangutan
